NO texture/blue_stained_glass.xpm
WE texture/daylight_detector_top.xpm
F 47,23,19
C 72,144,255

SO texture/bricks.xpm

EA texture/bookshelf_top.xpm

111111111111111111111111111111111
100000000000000000000000000000001
101100000111000000000000100000001
100000000000000000000000011111111
100000000000011000000000000000001
100000000000000000000000000000001        
100000000011000001110000011111111
100000000000000000000000010001    
100000000000000000001010010001    
11000000010100000000001000111    
100000010000100000001100000011111
1000001000000000000000000010001 
100000000000000000000000W01111 
1000000000011101010000000000001    
111111111111111111111111111111   