NO texture/blue_stained_glass.xpm

WE texture/daylight_detector_top.xpm

C    72,144,255

SO texture/bricks.xpm

EA texture/bookshelf_top.xpm

F 47,3,19

1111111111
1000000001 
1000000001 
1000001001 
1000100001 
1001 10001  
1000100001 
1000000001 
1N00000001 
1111111111 