NO     texture/blue_stained_glass.xpm
WE    texture/daylight_detector_top.xpm
F 47,23,19
    C 72,144,255

   SO texture/bricks.xpm

EA texture/bookshelf_top.xpm

        111111 1111111 1111111111
        111111 1111111 1111111111
        111111 1111111 1111111111
        1111111111111111111111111
        1000000000110000000000001
        1011000001110000000000001
        1111100000000000011111111
             110000000011        
1111111111111000011100001        
100000000011000001110111111111111
11110111111111011100000010001    
11110111111111011101010010001    
1100011000101011100000010001     
10001  10000100000001100000011111
10001  10001 1000001101010010001 
1101 11111011101111101111000111  
111111W1 1110101 101111010001    
11111111 1111111 111111111111     

ceace